R 1280 720

NO ./textures/eagle.xpm
SO ./textures/nazi.xpm
WE ./textures/mossy.xpm
EA ./textures/colorstone.xpm
S ./textures/barrel.xpm

F 152,79,255
C 255,0,25

        1111111111111111111111111
        1000000000110000000000001    111
        1011000001110000002000001   10001
        100100000000000000000000111110001
1111111111000001110000000000000000000011
10000000001100000111011110001111111111111
11110111111111011100000010001
11110111111111011101010010001
11000000110101011100000010001
10002000000000001100000010001
1000000000000001 101010010001
1100000111010101 111011110N0111
11110111 1110101 101111010001
11111111 1111111 111111111111
