R 1920 1020

NO ./textures/eagle.xpm
SO ./textures/nazi.xpm
WE ./textures/mossy.xpm
EA ./textures/colorstone.xpm
S ./textures/barrel.xpm

F 152,79,255
C 255,0,25

        1111111111111111111111111
        1000000000110000000200001    1111
         1011002001110000222000001   10001
        100100000000000000000000111110001
1111111111000001110000000000000000000011
1000000001100000111011110001111111111111
11110111111111011100000010001
11110111111111011101010010001
11000000110101011100200010001
1000200000000001 100000010001
1000000000000001 101010010001
1100000111010101 111011110N0111
11110111 1110101 101111010001
11111111 1111111 11111111111