R 3000 3000

NO ./textures/colorstone.xpm
SO ./textures/eagle.xpm
WE ./textures/greystone.xpm
EA ./textures/redbrick.xpm

S ./textures/barrel.xpm

F 220,100,0
C 225,30,0


        1111111111111111111111111
        1000000000110000000000001
        1011000001110000022200001
        1001000000000000002000001
111111111011000001110000000000001
1000000000110000011101111000011111
11110111111111011100000010001
11110111111111011101010010001
11000000110101011100000010001
10002000000000001100000010001
10000000000000001101010010001
11000001110101011111011110N0111
11110111 1110101 101111010001
11111111 1111111 111111111111