R 2560 1440
          
NO ./textures/colorstone.xpm
SO ./textures/nazi.xpm
WE ./textures/redbrick.xpm
EA ./textures/eagle.xpm

S ./textures/pillar.xpm

F 220,100,0
C 225,30,100

                                                         11111111
                                                        1000000001
                                                       100000000001
        1111111111111111111111111                     10000000000001
        1000000000110000000000001                    1000000000000001
        1011000001110000002000001                   100000000020000001
        1001000000000000000000001                  10000000000000000001
111111111011000001110000000000001                 1000000002000002000001
100000000011000001110111111111111                100000000000000000000001
11110111111111011100000010001                   10000000000000000000000001
1111011111111101110101001000111111111111111111111000000000001110000000111111
1100000011010101110000001000000000000000000000000000000000001 1000000000001
10002000000000001100000010000000000000000000000000000000000001 1000000000001
1000000000000000110101001000111111111111111111110000000000020010000000000001
11000001110101011111011110S01                   100000000000000000000000001
11110111 1110101 101111010001                    1000000000000000200000001
11111111 1111111 111111111111                     10000000000000000000001
                                                   100000002000000000001
                                                    1000000000000000001
                                                     10000000000000001
                                                      100000000000001
                                                       1000000000001
                                                        10000000001
                                                         100000001
                                                          1000001
                                                           10001
                                                            111
