R 1600 900

NO ./textures/colorstone.xpm
SO ./textures/nazi.xpm
WE ./textures/redbrick.xpm
EA ./textures/eagle.xpm

S ./textures/barrel.xpm

F 220,100,0
C 225,30,100

        1111111111111111111111111
        1000000000110000000000001
        1021000000000000002000001
        1021000000000000000000001
111111111011000001110000000000001
100000000011000001110111100011111
11110111111111011100000010001
11110111111111011101010010001
11000000110101011100000010001
10002000000000001100000010001
10000000000000001101010010001
11000000110101011111011110N0111
11110111 1110101 101111010001
11111111 11111111111111111111