R 1920 1080

NO ./textures/colorstone.xpm
SO ./textures/nazi.xpm
WE ./textures/redbrick.xpm
EA ./textures/eagle.xpm

S ./textures/pillar.xpm

F 220,100,0
C 225,30,100
                                                         11111111
                                                        1000000001
                                                       100000000001
        1111111111111111111111111                     10000000000001
        1000000000110000000000001                    1000000000000001
        1011000001110000002000001                   100000000000000001
        1001000000000000000000001                  10000000000000000001
111111111011000001110000000000001                 1000000000000000000001
100000000011000001110111111111111                100000000000000000000001
11110111111111011100000010001                   10000000000000000000000001
111101111111110111010100100011111111111111111111000000000000001000000000001
11000000110101011100000010000000000000000000000000000000000001 1000000000001
10002000000000001100000010000000000000000000000000000000000001 1000000000001
1000000000000000110101001000111111111111111111110000000000000010000000000001
11000001110101011111011110S01                   100000000000000000000000001
11110111 1110101 101111010001                    1000000000000000000000001
11111111 1111111 111111111111                     10000000000000000000001
                                                   100000000000000000001
                                                    1000000000000000001
                                                     10000000000000001
                                                      100000000000001
                                                       1000000000001
                                                        10000000001
                                                         100000001
                                                          1000001
                                                           10001
                                                            111
